date,location,new_cases,new_deaths,total_cases,total_deaths,weekly_cases,weekly_deaths,biweekly_cases,biweekly_deaths
1/1/2021,Australia,35,0,28460,909,163,1,334,1
1/2/2021,Australia,24,0,28484,909,176,1,316,1
1/3/2021,Australia,20,0,28504,909,167,0,306,1
1/4/2021,Australia,13,0,28517,909,168,0,298,1
1/5/2021,Australia,19,0,28536,909,155,0,299,1
1/6/2021,Australia,10,0,28546,909,141,0,284,1
1/7/2021,Australia,25,0,28571,909,146,0,297,1
1/8/2021,Australia,11,0,28582,909,122,0,285,1
1/9/2021,Australia,13,0,28595,909,111,0,287,1
1/10/2021,Australia,19,0,28614,909,110,0,277,0
1/11/2021,Australia,20,0,28634,909,117,0,285,0
1/12/2021,Australia,16,0,28650,909,114,0,269,0
1/13/2021,Australia,10,0,28660,909,114,0,255,0
1/14/2021,Australia,9,0,28669,909,98,0,244,0
1/15/2021,Australia,20,0,28689,909,107,0,229,0
1/16/2021,Australia,19,0,28708,909,113,0,224,0
1/17/2021,Australia,13,0,28721,909,107,0,217,0
1/18/2021,Australia,10,0,28731,909,97,0,214,0
1/19/2021,Australia,9,0,28740,909,90,0,204,0
1/20/2021,Australia,9,0,28749,909,89,0,203,0
1/21/2021,Australia,6,0,28755,909,86,0,184,0
1/22/2021,Australia,5,0,28760,909,71,0,178,0
1/23/2021,Australia,6,0,28766,909,58,0,171,0
1/24/2021,Australia,11,0,28777,909,56,0,163,0
1/25/2021,Australia,3,0,28780,909,49,0,146,0
1/26/2021,Australia,6,0,28786,909,46,0,136,0
1/27/2021,Australia,8,0,28794,909,45,0,134,0
1/28/2021,Australia,5,0,28799,909,44,0,130,0
1/29/2021,Australia,7,0,28806,909,46,0,117,0
1/30/2021,Australia,5,0,28811,909,45,0,103,0
1/31/2021,Australia,7,0,28818,909,41,0,97,0
2/1/2021,Australia,5,0,28823,909,43,0,92,0
2/2/2021,Australia,6,0,28829,909,43,0,89,0
2/3/2021,Australia,9,0,28838,909,44,0,89,0
2/4/2021,Australia,4,0,28842,909,43,0,87,0
2/5/2021,Australia,6,0,28848,909,42,0,88,0
2/6/2021,Australia,3,0,28851,909,40,0,85,0
2/7/2021,Australia,6,0,28857,909,39,0,80,0
2/8/2021,Australia,3,0,28860,909,37,0,80,0
2/9/2021,Australia,11,0,28871,909,42,0,85,0
2/10/2021,Australia,8,0,28879,909,41,0,85,0
2/11/2021,Australia,8,0,28887,909,45,0,88,0
2/12/2021,Australia,5,0,28892,909,44,0,86,0
2/13/2021,Australia,6,0,28898,909,47,0,87,0
2/14/2021,Australia,2,0,28900,909,43,0,82,0
2/15/2021,Australia,5,0,28905,909,45,0,82,0
2/16/2021,Australia,6,0,28911,909,40,0,82,0
2/17/2021,Australia,1,0,28912,909,33,0,74,0
2/18/2021,Australia,6,0,28918,909,31,0,76,0
2/19/2021,Australia,2,0,28920,909,28,0,72,0
2/20/2021,Australia,6,0,28926,909,28,0,75,0
2/21/2021,Australia,4,0,28930,909,30,0,73,0
2/22/2021,Australia,7,0,28937,909,32,0,77,0
2/23/2021,Australia,2,0,28939,909,28,0,68,0
2/24/2021,Australia,8,0,28947,909,35,0,68,0
2/25/2021,Australia,10,0,28957,909,39,0,70,0
2/26/2021,Australia,8,0,28965,909,45,0,73,0
2/27/2021,Australia,5,0,28970,909,44,0,72,0
2/28/2021,Australia,8,0,28978,909,48,0,78,0
3/1/2021,Australia,8,0,28986,909,49,0,81,0
3/2/2021,Australia,10,0,28996,909,57,0,85,0
3/3/2021,Australia,11,0,29007,909,60,0,95,0
3/4/2021,Australia,14,0,29021,909,64,0,103,0
3/5/2021,Australia,8,0,29029,909,64,0,109,0
3/6/2021,Australia,5,0,29034,909,64,0,108,0
3/7/2021,Australia,12,0,29046,909,68,0,116,0
3/8/2021,Australia,15,0,29061,909,75,0,124,0
3/9/2021,Australia,13,0,29074,909,78,0,135,0
3/10/2021,Australia,16,0,29090,909,83,0,143,0
3/11/2021,Australia,12,0,29102,909,81,0,145,0
3/12/2021,Australia,10,0,29112,909,83,0,147,0
3/13/2021,Australia,5,0,29117,909,83,0,147,0
3/14/2021,Australia,13,0,29130,909,84,0,152,0
3/15/2021,Australia,7,0,29137,909,76,0,151,0
3/16/2021,Australia,17,0,29154,909,80,0,158,0
3/17/2021,Australia,12,0,29166,909,76,0,159,0
3/18/2021,Australia,17,0,29183,909,81,0,162,0
3/19/2021,Australia,9,0,29192,909,80,0,163,0
3/20/2021,Australia,4,0,29196,909,79,0,162,0
3/21/2021,Australia,10,0,29206,909,76,0,160,0
3/22/2021,Australia,5,0,29211,909,74,0,150,0
3/23/2021,Australia,10,0,29221,909,67,0,147,0
3/24/2021,Australia,9,0,29230,909,64,0,140,0
3/25/2021,Australia,9,0,29239,909,56,0,137,0
3/26/2021,Australia,13,0,29252,909,60,0,140,0
3/27/2021,Australia,7,0,29259,909,63,0,142,0
3/28/2021,Australia,17,0,29276,909,70,0,146,0
3/29/2021,Australia,20,0,29296,909,85,0,159,0
3/30/2021,Australia,8,0,29304,909,83,0,150,0
3/31/2021,Australia,18,0,29322,909,92,0,156,0
4/1/2021,Australia,11,0,29333,909,94,0,150,0
4/2/2021,Australia,8,0,29341,909,89,0,149,0
4/3/2021,Australia,7,0,29348,909,89,0,152,0
4/4/2021,Australia,9,0,29357,909,81,0,151,0
4/5/2021,Australia,8,0,29365,909,69,0,154,0
4/6/2021,Australia,14,0,29379,909,75,0,158,0
4/7/2021,Australia,6,0,29385,909,63,0,155,0
4/8/2021,Australia,5,0,29390,909,57,0,151,0
4/9/2021,Australia,6,0,29396,909,55,0,144,0
4/10/2021,Australia,9,0,29405,909,57,0,146,0
4/11/2021,Australia,14,0,29419,909,62,0,143,0
4/12/2021,Australia,10,1,29429,910,64,1,133,1
4/13/2021,Australia,21,0,29450,910,71,1,146,1
4/14/2021,Australia,19,0,29469,910,84,1,147,1
4/15/2021,Australia,15,0,29484,910,94,1,151,1
4/16/2021,Australia,15,0,29499,910,103,1,158,1
4/17/2021,Australia,20,0,29519,910,114,1,171,1
4/18/2021,Australia,14,0,29533,910,114,1,176,1
4/19/2021,Australia,23,0,29556,910,127,0,191,1
4/20/2021,Australia,20,0,29576,910,126,0,197,1
4/21/2021,Australia,18,0,29594,910,125,0,209,1
4/22/2021,Australia,44,0,29638,910,154,0,248,1
4/23/2021,Australia,15,0,29653,910,154,0,257,1
4/24/2021,Australia,10,0,29663,910,144,0,258,1
4/25/2021,Australia,17,0,29680,910,147,0,261,1
4/26/2021,Australia,37,0,29717,910,161,0,288,0
4/27/2021,Australia,33,0,29750,910,174,0,300,0
4/28/2021,Australia,23,0,29773,910,179,0,304,0
4/29/2021,Australia,25,0,29798,910,160,0,314,0
4/30/2021,Australia,13,0,29811,910,158,0,312,0
5/1/2021,Australia,13,0,29824,910,161,0,305,0
5/2/2021,Australia,14,0,29838,910,158,0,305,0
5/3/2021,Australia,12,0,29850,910,133,0,294,0
5/4/2021,Australia,15,0,29865,910,115,0,289,0
5/5/2021,Australia,19,0,29884,910,111,0,290,0
5/6/2021,Australia,9,0,29893,910,95,0,255,0
5/7/2021,Australia,13,0,29906,910,95,0,253,0
5/8/2021,Australia,16,0,29922,910,98,0,259,0
5/9/2021,Australia,9,0,29931,910,93,0,251,0
5/10/2021,Australia,7,0,29938,910,88,0,221,0
5/11/2021,Australia,8,0,29946,910,81,0,196,0
5/12/2021,Australia,9,0,29955,910,71,0,182,0
5/13/2021,Australia,2,0,29957,910,64,0,159,0
5/14/2021,Australia,7,0,29964,910,58,0,153,0
5/15/2021,Australia,11,0,29975,910,53,0,151,0
5/16/2021,Australia,3,0,29978,910,47,0,140,0
5/17/2021,Australia,5,0,29983,910,45,0,133,0
5/18/2021,Australia,9,0,29992,910,46,0,127,0
5/19/2021,Australia,3,0,29995,910,40,0,111,0
5/20/2021,Australia,4,0,29999,910,42,0,106,0
5/21/2021,Australia,4,0,30003,910,39,0,97,0
5/22/2021,Australia,4,0,30007,910,32,0,85,0
5/23/2021,Australia,12,0,30019,910,41,0,88,0
5/24/2021,Australia,10,0,30029,910,46,0,91,0
5/25/2021,Australia,17,0,30046,910,54,0,100,0
5/26/2021,Australia,17,0,30063,910,68,0,108,0
5/27/2021,Australia,11,0,30074,910,75,0,117,0
5/28/2021,Australia,9,0,30083,910,80,0,119,0
5/29/2021,Australia,13,0,30096,910,89,0,121,0
5/30/2021,Australia,9,0,30105,910,86,0,127,0
5/31/2021,Australia,13,0,30118,910,89,0,135,0
6/1/2021,Australia,6,0,30124,910,78,0,132,0
1/1/2021,Italy,22210,462,2129376,74621,101022,3262,207598,6727
1/2/2021,Italy,11825,364,2141201,74985,102442,3365,203118,6538
1/3/2021,Italy,14245,347,2155446,75332,107750,3407,202261,6533
1/4/2021,Italy,10798,348,2166244,75680,109967,3310,202190,6466
1/5/2021,Italy,15375,649,2181619,76329,114132,3300,204249,6487
1/6/2021,Italy,20326,548,2201945,76877,118256,3273,210667,6482
1/7/2021,Italy,18416,414,2220361,77291,113195,3132,211044,6391
1/8/2021,Italy,17529,620,2237890,77911,108514,3290,209536,6552
1/9/2021,Italy,19976,483,2257866,78394,116665,3409,219107,6774
1/10/2021,Italy,18625,361,2276491,78755,121045,3423,228795,6830
1/11/2021,Italy,12530,448,2289021,79203,122777,3523,232744,6833
1/12/2021,Italy,14242,616,2303263,79819,121644,3490,235776,6790
1/13/2021,Italy,15773,507,2319036,80326,117091,3449,235347,6722
1/14/2021,Italy,17243,522,2336279,80848,115918,3557,229113,6689
1/15/2021,Italy,16144,477,2352423,81325,114533,3414,223047,6704
1/16/2021,Italy,16310,475,2368733,81800,110867,3406,227532,6815
1/17/2021,Italy,12544,377,2381277,82177,104786,3422,225831,6845
1/18/2021,Italy,8825,377,2390102,82554,101081,3351,223858,6874
1/19/2021,Italy,10496,603,2400598,83157,97335,3338,218979,6828
1/20/2021,Italy,13568,524,2414166,83681,95130,3355,212221,6804
1/21/2021,Italy,14055,521,2428221,84202,91942,3354,207860,6911
1/22/2021,Italy,13633,472,2441854,84674,89431,3349,203964,6763
1/23/2021,Italy,13331,488,2455185,85162,86452,3362,197319,6768
1/24/2021,Italy,11628,299,2466813,85461,85536,3284,190322,6706
1/25/2021,Italy,8559,420,2475372,85881,85270,3327,186351,6678
1/26/2021,Italy,10584,541,2485956,86422,85358,3265,182693,6603
1/27/2021,Italy,15191,467,2501147,86889,86981,3208,182111,6563
1/28/2021,Italy,14360,492,2515507,87381,87286,3179,179228,6533
1/29/2021,Italy,13563,477,2529070,87858,87216,3184,176647,6533
1/30/2021,Italy,12713,421,2541783,88279,86598,3117,173050,6479
1/31/2021,Italy,11249,237,2553032,88516,86219,3055,171755,6339
2/1/2021,Italy,7925,329,2560957,88845,85585,2964,170855,6291
2/2/2021,Italy,9651,499,2570608,89344,84652,2922,170010,6187
2/3/2021,Italy,13182,476,2583790,89820,82643,2931,169624,6139
2/4/2021,Italy,13656,421,2597446,90241,81939,2860,169225,6039
2/5/2021,Italy,14213,377,2611659,90618,82589,2760,169805,5944
2/6/2021,Italy,13439,385,2625098,91003,83315,2724,169913,5841
2/7/2021,Italy,11640,270,2636738,91273,83706,2757,169925,5812
2/8/2021,Italy,7969,307,2644707,91580,83750,2735,169335,5699
2/9/2021,Italy,10612,422,2655319,92002,84711,2658,169363,5580
2/10/2021,Italy,12947,336,2668266,92338,84476,2518,167119,5449
2/11/2021,Italy,15137,391,2683403,92729,85957,2488,167896,5348
2/12/2021,Italy,13893,316,2697296,93045,85637,2427,168226,5187
2/13/2021,Italy,13523,311,2710819,93356,85721,2353,169036,5077
2/14/2021,Italy,11060,221,2721879,93577,85141,2304,168847,5061
2/15/2021,Italy,7344,258,2729223,93835,84516,2255,168266,4990
2/16/2021,Italy,10368,336,2739591,94171,84272,2169,168983,4827
2/17/2021,Italy,12066,369,2751657,94540,83391,2202,167867,4720
2/18/2021,Italy,13755,347,2765412,94887,82009,2158,167966,4646
2/19/2021,Italy,15470,348,2780882,95235,83586,2190,169223,4617
2/20/2021,Italy,14914,251,2795796,95486,84977,2130,170698,4483
2/21/2021,Italy,13450,232,2809246,95718,87367,2141,172508,4445
2/22/2021,Italy,9617,274,2818863,95992,89640,2157,174156,4412
2/23/2021,Italy,13299,356,2832162,96348,92571,2177,176843,4346
2/24/2021,Italy,16402,318,2848564,96666,96907,2126,180298,4328
2/25/2021,Italy,19871,308,2868435,96974,103023,2087,185032,4245
2/26/2021,Italy,20488,253,2888923,97227,108041,1992,191627,4182
2/27/2021,Italy,18902,280,2907825,97507,112029,2021,197006,4151
2/28/2021,Italy,17440,192,2925265,97699,116019,1981,203386,4122
3/1/2021,Italy,13106,246,2938371,97945,119508,1953,209148,4110
3/2/2021,Italy,17063,343,2955434,98288,123272,1940,215843,4117
3/3/2021,Italy,20840,347,2976274,98635,127710,1969,224617,4095
3/4/2021,Italy,22845,339,2999119,98974,130684,2000,233707,4087
3/5/2021,Italy,24010,297,3023129,99271,134206,2044,242247,4036
3/6/2021,Italy,23633,307,3046762,99578,138937,2071,250966,4092
3/7/2021,Italy,20724,207,3067486,99785,142221,2086,258240,4067
3/8/2021,Italy,13882,318,3081368,100103,142997,2158,262505,4111
3/9/2021,Italy,19725,376,3101093,100479,145659,2191,268931,4131
3/10/2021,Italy,22275,332,3123368,100811,147094,2176,274804,4145
3/11/2021,Italy,25649,373,3149017,101184,149898,2210,280582,4210
3/12/2021,Italy,26790,380,3175807,101564,152678,2293,286884,4337
3/13/2021,Italy,26031,317,3201838,101881,155076,2303,294013,4374
3/14/2021,Italy,21304,264,3223142,102145,155656,2360,297877,4446
3/15/2021,Italy,15252,354,3238394,102499,157026,2396,300023,4554
3/16/2021,Italy,20376,502,3258770,103001,157677,2522,303336,4713
3/17/2021,Italy,23040,431,3281810,103432,158442,2621,305536,4797
3/18/2021,Italy,24901,423,3306711,103855,157694,2671,307592,4881
3/19/2021,Italy,25707,386,3332418,104241,156611,2677,309289,4970
3/20/2021,Italy,23913,401,3356331,104642,154493,2761,309569,5064
3/21/2021,Italy,20045,300,3376376,104942,153234,2797,308890,5157
3/22/2021,Italy,24501,386,3400877,105328,162483,2829,319509,5225
3/23/2021,Italy,18739,551,3419616,105879,160846,2878,318523,5400
3/24/2021,Italy,21246,460,3440862,106339,159052,2907,317494,5528
3/25/2021,Italy,23681,460,3464543,106799,157832,2944,315526,5615
3/26/2021,Italy,24076,457,3488619,107256,156201,3015,312812,5692
3/27/2021,Italy,23834,380,3512453,107636,156122,2994,310615,5755
3/28/2021,Italy,19604,297,3532057,107933,155681,2991,308915,5788
3/29/2021,Italy,12900,417,3544957,108350,144080,3022,306563,5851
3/30/2021,Italy,16055,529,3561012,108879,141396,3000,302242,5878
3/31/2021,Italy,23887,467,3584899,109346,144037,3007,303089,5914
4/1/2021,Italy,22184,501,3607083,109847,142540,3048,300372,5992
4/2/2021,Italy,21917,481,3629000,110328,140381,3072,296582,6087
4/3/2021,Italy,21247,376,3650247,110704,137794,3068,293916,6062
4/4/2021,Italy,18017,326,3668264,111030,136207,3097,291888,6088
4/5/2021,Italy,10680,296,3678944,111326,133987,2976,278067,5998
4/6/2021,Italy,7763,421,3686707,111747,125695,2868,267091,5868
4/7/2021,Italy,13686,627,3700393,112374,115494,3028,259531,6035
4/8/2021,Italy,17209,487,3717602,112861,110519,3014,253059,6062
4/9/2021,Italy,18924,718,3736526,113579,107526,3251,247907,6323
4/10/2021,Italy,17551,344,3754077,113923,103830,3219,241624,6287
4/11/2021,Italy,15737,331,3769814,114254,101550,3224,237757,6321
4/12/2021,Italy,9780,358,3779594,114612,100650,3286,234637,6262
4/13/2021,Italy,13439,476,3793033,115088,106326,3341,232021,6209
4/14/2021,Italy,16160,469,3809193,115557,108800,3183,224294,6211
4/15/2021,Italy,16963,380,3826156,115937,108554,3076,219073,6090
4/16/2021,Italy,15923,429,3842079,116366,105553,2787,213079,6038
4/17/2021,Italy,15364,310,3857443,116676,103366,2753,207196,5972
4/18/2021,Italy,12688,251,3870131,116927,100317,2673,201867,5897
4/19/2021,Italy,8863,316,3878994,117243,99400,2631,200050,5917
4/20/2021,Italy,12069,390,3891063,117633,98030,2545,204356,5886
4/21/2021,Italy,13836,364,3904899,117997,95706,2440,204506,5623
4/22/2021,Italy,16046,360,3920945,118357,94789,2420,203343,5496
4/23/2021,Italy,14758,342,3935703,118699,93624,2333,199177,5120
4/24/2021,Italy,13814,322,3949517,119021,92074,2345,195440,5098
4/25/2021,Italy,13157,217,3962674,119238,92543,2311,192860,4984
4/26/2021,Italy,8440,301,3971114,119539,92120,2296,191520,4927
4/27/2021,Italy,10398,373,3981512,119912,90449,2279,188479,4824
4/28/2021,Italy,13382,344,3994894,120256,89995,2259,185701,4699
4/29/2021,Italy,14314,288,4009208,120544,88263,2187,183052,4607
4/30/2021,Italy,13445,263,4022653,120807,86950,2108,180574,4441
5/1/2021,Italy,12964,226,4035617,121033,86100,2012,178174,4357
5/2/2021,Italy,9145,144,4044762,121177,82088,1939,174631,4250
5/3/2021,Italy,5946,256,4050708,121433,79594,1894,171714,4190
5/4/2021,Italy,9113,305,4059821,121738,78309,1826,168758,4105
5/5/2021,Italy,10579,267,4070400,122005,75506,1749,165501,4008
5/6/2021,Italy,11798,258,4082198,122263,72990,1719,161253,3906
5/7/2021,Italy,10549,207,4092747,122470,70094,1663,157044,3771
5/8/2021,Italy,10174,224,4102921,122694,67304,1661,153404,3673
5/9/2021,Italy,8289,139,4111210,122833,66448,1656,148536,3595
5/10/2021,Italy,5077,198,4116287,123031,65579,1598,145173,3492
5/11/2021,Italy,6943,251,4123230,123282,63409,1544,141718,3370
5/12/2021,Italy,7848,262,4131078,123544,60678,1539,136184,3288
5/13/2021,Italy,8082,201,4139160,123745,56962,1482,129952,3201
5/14/2021,Italy,7562,182,4146722,123927,53975,1457,124069,3120
5/15/2021,Italy,6652,136,4153374,124063,50453,1369,117757,3030
5/16/2021,Italy,5748,93,4159122,124156,47912,1323,114360,2979
5/17/2021,Italy,3454,140,4162576,124296,46289,1265,111868,2863
5/18/2021,Italy,4449,201,4167025,124497,43795,1215,107204,2759
5/19/2021,Italy,5500,149,4172525,124646,41447,1102,102125,2641
5/20/2021,Italy,5736,164,4178261,124810,39101,1065,96063,2547
5/21/2021,Italy,5215,218,4183476,125028,36754,1101,90729,2558
5/22/2021,Italy,4714,125,4188190,125153,34816,1090,85269,2459
5/23/2021,Italy,3993,72,4192183,125225,33061,1069,80973,2392
5/24/2021,Italy,2489,110,4194672,125335,32096,1039,78385,2304
5/25/2021,Italy,3220,166,4197892,125501,30867,1004,74662,2219
5/26/2021,Italy,3935,121,4201827,125622,29302,976,70749,2078
5/27/2021,Italy,4143,171,4205970,125793,27709,983,66810,2048
5/28/2021,Italy,3737,126,4209707,125919,26231,891,62985,1992
5/29/2021,Italy,3348,83,4213055,126002,24865,849,59681,1939
5/30/2021,Italy,2948,44,4216003,126046,23820,821,56881,1890
5/31/2021,Italy,1818,82,4217821,126128,23149,793,55245,1832
6/1/2021,Italy,2483,93,4220304,126221,22412,720,53279,1724
1/1/2021,South Africa,16726,418,1073887,28887,90528,2611,172349,4602
1/2/2021,South Africa,15002,288,1088889,29175,93978,2654,176412,4636
1/3/2021,South Africa,11859,402,1100748,29577,96335,2842,178826,4886
1/4/2021,South Africa,12601,434,1113349,30011,101478,2940,182638,5104
1/5/2021,South Africa,14410,513,1127759,30524,106308,2956,187547,5278
1/6/2021,South Africa,21832,844,1149591,31368,110430,3335,195333,5711
1/7/2021,South Africa,20999,441,1170590,31809,113429,3340,202027,5826
1/8/2021,South Africa,21980,616,1192570,32425,118683,3538,209211,6149
1/9/2021,South Africa,21606,399,1214176,32824,125287,3649,219265,6303
1/10/2021,South Africa,17421,339,1231597,33163,130849,3586,227184,6428
1/11/2021,South Africa,15046,416,1246643,33579,133294,3568,234772,6508
1/12/2021,South Africa,13105,755,1259748,34334,131989,3810,238297,6766
1/13/2021,South Africa,18555,806,1278303,35140,128712,3772,239142,7107
1/14/2021,South Africa,18503,712,1296806,35852,126216,4043,239645,7383
1/15/2021,South Africa,14880,615,1311686,36467,119116,4042,237799,7580
1/16/2021,South Africa,13973,384,1325659,36851,111483,4027,236770,7676
1/17/2021,South Africa,12267,254,1337926,37105,106329,3942,237178,7528
1/18/2021,South Africa,9010,344,1346936,37449,100293,3870,233587,7438
1/19/2021,South Africa,9780,839,1356716,38288,96968,3954,228957,7764
1/20/2021,South Africa,12710,566,1369426,38854,91123,3714,219835,7486
1/21/2021,South Africa,11381,647,1380807,39501,84001,3649,210217,7692
1/22/2021,South Africa,11761,575,1392568,40076,80882,3609,199998,7651
1/23/2021,South Africa,12271,498,1404839,40574,79180,3723,190663,7750
1/24/2021,South Africa,8147,300,1412986,40874,75060,3769,181389,7711
1/25/2021,South Africa,4551,243,1417537,41117,70601,3668,170894,7538
1/26/2021,South Africa,6041,680,1423578,41797,66862,3509,163830,7463
1/27/2021,South Africa,7070,753,1430648,42550,61222,3696,152345,7410
1/28/2021,South Africa,7150,555,1437798,43105,56991,3604,140992,7253
1/29/2021,South Africa,6141,528,1443939,43633,51371,3557,132253,7166
1/30/2021,South Africa,5297,318,1449236,43951,44397,3377,123577,7100
1/31/2021,South Africa,4525,213,1453761,44164,40775,3290,115835,7059
2/1/2021,South Africa,2548,235,1456309,44399,38772,3282,109373,6950
2/2/2021,South Africa,2649,547,1458958,44946,35380,3149,102242,6658
2/3/2021,South Africa,4058,398,1463016,45344,32368,2794,93590,6490
2/4/2021,South Africa,3751,261,1466767,45605,28969,2500,85960,6104
2/5/2021,South Africa,3749,297,1470516,45902,26577,2269,77948,5826
2/6/2021,South Africa,3184,278,1473700,46180,24464,2229,68861,5606
2/7/2021,South Africa,2435,110,1476135,46290,22374,2126,63149,5416
2/8/2021,South Africa,1376,183,1477511,46473,21202,2074,59974,5356
2/9/2021,South Africa,1742,396,1479253,46869,20295,1923,55675,5072
2/10/2021,South Africa,3159,276,1482412,47145,19396,1801,51764,4595
2/11/2021,South Africa,2488,237,1484900,47382,18133,1777,47102,4277
2/12/2021,South Africa,2781,288,1487681,47670,17165,1768,43742,4037
2/13/2021,South Africa,2382,151,1490063,47821,16363,1641,40827,3870
2/14/2021,South Africa,1744,78,1491807,47899,15672,1609,38046,3735
2/15/2021,South Africa,1102,195,1492909,48094,15398,1621,36600,3695
2/16/2021,South Africa,1210,219,1494119,48313,14866,1444,35161,3367
2/17/2021,South Africa,2320,165,1496439,48478,14027,1333,33423,3134
2/18/2021,South Africa,2327,230,1498766,48708,13866,1326,31999,3103
2/19/2021,South Africa,1911,151,1500677,48859,12996,1189,30161,2957
2/20/2021,South Africa,1690,81,1502367,48940,12304,1119,28667,2760
2/21/2021,South Africa,1429,113,1503796,49053,11989,1154,27661,2763
2/22/2021,South Africa,792,97,1504588,49150,11679,1056,27077,2677
2/23/2021,South Africa,998,263,1505586,49413,11467,1100,26333,2544
2/24/2021,South Africa,1862,110,1507448,49523,11009,1045,25036,2378
2/25/2021,South Africa,1676,144,1509124,49667,10358,959,24224,2285
2/26/2021,South Africa,1654,117,1510778,49784,10101,925,23097,2114
2/27/2021,South Africa,1447,157,1512225,49941,9858,1001,22162,2120
2/28/2021,South Africa,1168,52,1513393,49993,9597,940,21586,2094
3/1/2021,South Africa,566,84,1513959,50077,9371,927,21050,1983
3/2/2021,South Africa,856,194,1514815,50271,9229,858,20696,1958
3/3/2021,South Africa,1447,95,1516262,50366,8814,843,19823,1888
3/4/2021,South Africa,1404,96,1517666,50462,8542,795,18900,1754
3/5/2021,South Africa,1313,104,1518979,50566,8201,782,18302,1707
3/6/2021,South Africa,1227,81,1520206,50647,7981,706,17839,1707
3/7/2021,South Africa,862,31,1521068,50678,7675,685,17272,1625
3/8/2021,South Africa,638,125,1521706,50803,7747,726,17118,1653
3/9/2021,South Africa,991,103,1522697,50906,7882,635,17111,1493
3/10/2021,South Africa,1477,109,1524174,51015,7912,649,16726,1492
3/11/2021,South Africa,1474,95,1525648,51110,7982,648,16524,1443
3/12/2021,South Africa,1225,69,1526873,51179,7894,613,16095,1395
3/13/2021,South Africa,1541,82,1528414,51261,8208,614,16189,1320
3/14/2021,South Africa,1006,65,1529420,51326,8352,648,16027,1333
3/15/2021,South Africa,613,95,1530033,51421,8327,618,16074,1344
3/16/2021,South Africa,933,139,1530966,51560,8269,654,16151,1289
3/17/2021,South Africa,1531,74,1532497,51634,8323,619,16235,1268
3/18/2021,South Africa,1464,90,1533961,51724,8313,614,16295,1262
3/19/2021,South Africa,1462,311,1535423,52035,8550,856,16444,1469
3/20/2021,South Africa,1378,47,1536801,52082,8387,821,16595,1435
3/21/2021,South Africa,1051,29,1537852,52111,8432,785,16784,1433
3/22/2021,South Africa,599,85,1538451,52196,8418,775,16745,1393
3/23/2021,South Africa,510,55,1538961,52251,7995,691,16264,1345
3/24/2021,South Africa,1048,121,1540009,52372,7512,738,15835,1357
3/25/2021,South Africa,1554,163,1541563,52535,7602,811,15915,1425
3/26/2021,South Africa,1516,67,1543079,52602,7656,567,16206,1423
3/27/2021,South Africa,1387,46,1544466,52648,7665,566,16052,1387
3/28/2021,South Africa,965,15,1545431,52663,7579,552,16011,1337
3/29/2021,South Africa,548,47,1545979,52710,7528,514,15946,1289
3/30/2021,South Africa,756,78,1546735,52788,7774,537,15769,1228
3/31/2021,South Africa,1422,58,1548157,52846,8148,474,15660,1212
4/1/2021,South Africa,1294,51,1549451,52897,7888,362,15490,1173
4/2/2021,South Africa,1273,49,1550724,52946,7645,344,15301,911
4/3/2021,South Africa,777,8,1551501,52954,7035,306,14700,872
4/4/2021,South Africa,463,33,1551964,52987,6533,324,14112,876
4/5/2021,South Africa,452,8,1552416,52995,6437,285,13965,799
4/6/2021,South Africa,437,37,1552853,53032,6118,244,13892,781
4/7/2021,South Africa,756,79,1553609,53111,5452,265,13600,739
4/8/2021,South Africa,1366,62,1554975,53173,5524,276,13412,638
4/9/2021,South Africa,1267,53,1556242,53226,5518,280,13163,624
4/10/2021,South Africa,1285,30,1557527,53256,6026,302,13061,608
4/11/2021,South Africa,931,66,1558458,53322,6494,335,13027,659
4/12/2021,South Africa,655,34,1559113,53356,6697,361,13134,646
4/13/2021,South Africa,847,67,1559960,53423,7107,391,13225,635
4/14/2021,South Africa,1599,75,1561559,53498,7950,387,13402,652
4/15/2021,South Africa,1372,73,1562931,53571,7956,398,13480,674
4/16/2021,South Africa,1424,92,1564355,53663,8113,437,13631,717
4/17/2021,South Africa,1325,48,1565680,53711,8153,455,14179,757
4/18/2021,South Africa,1089,25,1566769,53736,8311,414,14805,749
4/19/2021,South Africa,744,21,1567513,53757,8400,401,15097,762
4/20/2021,South Africa,853,130,1568366,53887,8406,464,15513,855
4/21/2021,South Africa,1569,53,1569935,53940,8376,442,16326,829
4/22/2021,South Africa,1413,55,1571348,53995,8417,424,16373,822
4/23/2021,South Africa,1637,71,1572985,54066,8630,403,16743,840
4/24/2021,South Africa,1385,59,1574370,54125,8690,414,16843,869
4/25/2021,South Africa,1101,23,1575471,54148,8702,412,17013,826
4/26/2021,South Africa,849,38,1576320,54186,8807,429,17207,830
4/27/2021,South Africa,880,51,1577200,54237,8834,350,17240,814
4/28/2021,South Africa,1250,48,1578450,54285,8515,345,16891,787
4/29/2021,South Africa,1086,46,1579536,54331,8188,336,16605,760
4/30/2021,South Africa,1674,19,1581210,54350,8225,284,16855,687
5/1/2021,South Africa,1632,56,1582842,54406,8472,281,17162,695
5/2/2021,South Africa,1222,11,1584064,54417,8593,269,17295,681
5/3/2021,South Africa,897,35,1584961,54452,8641,266,17448,695
5/4/2021,South Africa,1187,59,1586148,54511,8948,274,17782,624
5/5/2021,South Africa,2073,46,1588221,54557,9771,272,18286,617
5/6/2021,South Africa,2149,63,1590370,54620,10834,289,19022,625
5/7/2021,South Africa,2256,67,1592626,54687,11416,337,19641,621
5/8/2021,South Africa,0,0,1592626,54687,9784,281,18256,562
5/9/2021,South Africa,3969,48,1596595,54735,12531,318,21124,587
5/10/2021,South Africa,1129,90,1597724,54825,12763,373,21404,639
5/11/2021,South Africa,1548,71,1599272,54896,13124,385,22072,659
5/12/2021,South Africa,2759,72,1602031,54968,13810,411,23581,683
5/13/2021,South Africa,3221,44,1605252,55012,14882,392,25716,681
5/14/2021,South Africa,3141,112,1608393,55124,15767,437,27183,774
5/15/2021,South Africa,2750,59,1611143,55183,18517,496,28301,777
5/16/2021,South Africa,2585,27,1613728,55210,17133,475,29664,793
5/17/2021,South Africa,1757,50,1615485,55260,17761,435,30524,808
5/18/2021,South Africa,2355,80,1617840,55340,18568,444,31692,829
5/19/2021,South Africa,3522,167,1621362,55507,19331,539,33141,950
5/20/2021,South Africa,3641,61,1625003,55568,19751,556,34633,948
5/21/2021,South Africa,3332,151,1628335,55719,19942,595,35709,1032
5/22/2021,South Africa,4236,53,1632571,55772,21428,589,39945,1085
5/23/2021,South Africa,2894,30,1635465,55802,21737,592,38870,1067
5/24/2021,South Africa,2383,72,1637848,55874,22363,614,40124,1049
5/25/2021,South Africa,0,102,1637848,55976,20008,636,38576,1080
5/26/2021,South Africa,7707,101,1645555,56077,24193,570,43524,1109
5/27/2021,South Africa,4422,93,1649977,56170,24974,602,44725,1158
5/28/2021,South Africa,4574,123,1654551,56293,26216,574,46158,1169
5/29/2021,South Africa,4519,70,1659070,56363,26499,591,47927,1180
5/30/2021,South Africa,0,0,1659070,56363,23605,561,45342,1153
5/31/2021,South Africa,6547,143,1665617,56506,27769,632,50132,1246
6/1/2021,South Africa,3614,95,1669231,56601,31383,625,51391,1261
1/1/2021,South Korea,824,25,62593,942,6691,149,14023,283
1/2/2021,South Korea,651,20,63244,962,6372,154,13579,288
1/3/2021,South Korea,1020,19,64264,981,6584,162,13673,283
1/4/2021,South Korea,715,26,64979,1007,6254,148,13519,285
1/5/2021,South Korea,839,20,65818,1027,6045,148,13268,288
1/6/2021,South Korea,868,19,66686,1046,5946,146,13153,290
1/7/2021,South Korea,672,35,67358,1081,5589,164,12588,308
1/8/2021,South Korea,641,19,67999,1100,5406,158,12097,307
1/9/2021,South Korea,665,25,68664,1125,5420,163,11792,317
1/10/2021,South Korea,450,15,69114,1140,4850,159,11434,321
1/11/2021,South Korea,537,25,69651,1165,4672,158,10926,306
1/12/2021,South Korea,561,20,70212,1185,4394,158,10439,306
1/13/2021,South Korea,516,10,70728,1195,4042,149,9988,295
1/14/2021,South Korea,513,22,71241,1217,3883,136,9472,300
1/15/2021,South Korea,579,19,71820,1236,3821,136,9227,294
1/16/2021,South Korea,520,13,72340,1249,3676,124,9096,287
1/17/2021,South Korea,389,15,72729,1264,3615,124,8465,283
1/18/2021,South Korea,386,19,73115,1283,3464,118,8136,276
1/19/2021,South Korea,403,17,73518,1300,3306,115,7700,273
1/20/2021,South Korea,400,16,73918,1316,3190,121,7232,270
1/21/2021,South Korea,344,12,74262,1328,3021,111,6904,247
1/22/2021,South Korea,430,9,74692,1337,2872,101,6693,237
1/23/2021,South Korea,392,12,75084,1349,2744,100,6420,224
1/24/2021,South Korea,437,11,75521,1360,2792,96,6407,220
1/25/2021,South Korea,354,11,75875,1371,2760,88,6224,206
1/26/2021,South Korea,554,7,76429,1378,2911,78,6217,193
1/27/2021,South Korea,497,8,76926,1386,3008,70,6198,191
1/28/2021,South Korea,469,13,77395,1399,3133,71,6154,182
1/29/2021,South Korea,455,15,77850,1414,3158,77,6030,178
1/30/2021,South Korea,355,6,78205,1420,3121,71,5865,171
1/31/2021,South Korea,303,5,78508,1425,2987,65,5779,161
2/1/2021,South Korea,336,10,78844,1435,2969,64,5729,152
2/2/2021,South Korea,467,6,79311,1441,2882,63,5793,141
2/3/2021,South Korea,451,7,79762,1448,2836,62,5844,132
2/4/2021,South Korea,369,11,80131,1459,2736,60,5869,131
2/5/2021,South Korea,393,5,80524,1464,2674,50,5832,127
2/6/2021,South Korea,372,7,80896,1471,2691,51,5812,122
2/7/2021,South Korea,289,3,81185,1474,2677,49,5664,114
2/8/2021,South Korea,302,8,81487,1482,2643,47,5612,111
2/9/2021,South Korea,443,4,81930,1486,2619,45,5501,108
2/10/2021,South Korea,504,10,82434,1496,2672,48,5508,110
2/11/2021,South Korea,403,11,82837,1507,2706,48,5442,108
2/12/2021,South Korea,362,7,83199,1514,2675,50,5349,100
2/13/2021,South Korea,326,8,83525,1522,2629,51,5320,102
2/14/2021,South Korea,344,5,83869,1527,2684,53,5361,102
2/15/2021,South Korea,456,7,84325,1534,2838,52,5481,99
2/16/2021,South Korea,621,4,84946,1538,3016,52,5635,97
2/17/2021,South Korea,621,6,85567,1544,3133,48,5805,96
2/18/2021,South Korea,561,6,86128,1550,3291,43,5997,91
2/19/2021,South Korea,446,3,86574,1553,3375,39,6050,89
2/20/2021,South Korea,418,4,86992,1557,3467,35,6096,86
2/21/2021,South Korea,332,5,87324,1562,3455,35,6139,88
2/22/2021,South Korea,357,11,87681,1573,3356,39,6194,91
2/23/2021,South Korea,439,3,88120,1576,3174,38,6190,90
2/24/2021,South Korea,396,5,88516,1581,2949,37,6082,85
2/25/2021,South Korea,406,4,88922,1585,2794,35,6085,78
2/26/2021,South Korea,399,10,89321,1595,2747,42,6122,81
2/27/2021,South Korea,355,8,89676,1603,2684,46,6151,81
2/28/2021,South Korea,355,2,90031,1605,2707,43,6162,78
3/1/2021,South Korea,341,1,90372,1606,2691,33,6047,72
3/2/2021,South Korea,444,6,90816,1612,2696,36,5870,74
3/3/2021,South Korea,424,7,91240,1619,2724,38,5673,75
3/4/2021,South Korea,398,8,91638,1627,2716,42,5510,77
3/5/2021,South Korea,417,5,92055,1632,2734,37,5481,79
3/6/2021,South Korea,416,2,92471,1634,2795,31,5479,77
3/7/2021,South Korea,346,8,92817,1642,2786,37,5493,80
3/8/2021,South Korea,446,3,93263,1645,2891,39,5582,72
3/9/2021,South Korea,470,3,93733,1648,2917,36,5613,72
3/10/2021,South Korea,465,4,94198,1652,2958,33,5682,71
3/11/2021,South Korea,488,10,94686,1662,3048,35,5764,77
3/12/2021,South Korea,490,5,95176,1667,3121,35,5855,72
3/13/2021,South Korea,459,2,95635,1669,3164,35,5959,66
3/14/2021,South Korea,382,6,96017,1675,3200,33,5986,70
3/15/2021,South Korea,363,3,96380,1678,3117,33,6008,72
3/16/2021,South Korea,469,8,96849,1686,3116,38,6033,74
3/17/2021,South Korea,445,2,97294,1688,3096,36,6054,69
3/18/2021,South Korea,463,2,97757,1690,3071,28,6119,63
3/19/2021,South Korea,452,3,98209,1693,3033,26,6154,61
3/20/2021,South Korea,456,3,98665,1696,3030,27,6194,62
3/21/2021,South Korea,410,1,99075,1697,3058,22,6258,55
3/22/2021,South Korea,346,7,99421,1704,3041,26,6158,59
3/23/2021,South Korea,425,3,99846,1707,2997,21,6113,59
3/24/2021,South Korea,430,2,100276,1709,2982,21,6078,57
3/25/2021,South Korea,494,7,100770,1716,3013,26,6084,54
3/26/2021,South Korea,505,5,101275,1721,3066,28,6099,54
3/27/2021,South Korea,482,1,101757,1722,3092,26,6122,53
3/28/2021,South Korea,384,4,102141,1726,3066,29,6124,51
3/29/2021,South Korea,441,3,102582,1729,3161,25,6202,51
3/30/2021,South Korea,506,2,103088,1731,3242,24,6239,45
3/31/2021,South Korea,551,4,103639,1735,3363,26,6345,47
4/1/2021,South Korea,555,2,104194,1737,3424,21,6437,47
4/2/2021,South Korea,542,3,104736,1740,3461,19,6527,47
4/3/2021,South Korea,543,4,105279,1744,3522,22,6614,48
4/4/2021,South Korea,473,4,105752,1748,3611,22,6677,51
4/5/2021,South Korea,478,4,106230,1752,3648,23,6809,48
4/6/2021,South Korea,668,4,106898,1756,3810,25,7052,49
4/7/2021,South Korea,700,2,107598,1758,3959,23,7322,49
4/8/2021,South Korea,671,6,108269,1764,4075,27,7499,48
4/9/2021,South Korea,676,1,108945,1765,4209,25,7670,44
4/10/2021,South Korea,614,3,109559,1768,4280,24,7802,46
4/11/2021,South Korea,587,2,110146,1770,4394,22,8005,44
4/12/2021,South Korea,542,5,110688,1775,4458,23,8106,46
4/13/2021,South Korea,731,7,111419,1782,4521,26,8331,51
4/14/2021,South Korea,698,6,112117,1788,4519,30,8478,53
4/15/2021,South Korea,672,2,112789,1790,4520,26,8595,53
4/16/2021,South Korea,655,4,113444,1794,4499,29,8708,54
4/17/2021,South Korea,671,3,114115,1797,4556,29,8836,53
4/18/2021,South Korea,531,4,114646,1801,4500,31,8894,53
4/19/2021,South Korea,549,1,115195,1802,4507,27,8965,50
4/20/2021,South Korea,731,4,115926,1806,4507,24,9028,50
4/21/2021,South Korea,735,2,116661,1808,4544,20,9063,50
4/22/2021,South Korea,797,3,117458,1811,4669,21,9189,47
4/23/2021,South Korea,785,1,118243,1812,4799,18,9298,47
4/24/2021,South Korea,644,1,118887,1813,4772,16,9328,45
4/25/2021,South Korea,500,4,119387,1817,4741,16,9241,47
4/26/2021,South Korea,511,3,119898,1820,4703,18,9210,45
4/27/2021,South Korea,775,1,120673,1821,4747,15,9254,39
4/28/2021,South Korea,678,4,121351,1825,4690,17,9234,37
4/29/2021,South Korea,656,3,122007,1828,4549,17,9218,38
4/30/2021,South Korea,627,3,122634,1831,4391,19,9190,37
5/1/2021,South Korea,606,2,123240,1833,4353,20,9125,36
5/2/2021,South Korea,488,1,123728,1834,4341,17,9082,33
5/3/2021,South Korea,541,6,124269,1840,4371,20,9074,38
5/4/2021,South Korea,676,7,124945,1847,4272,26,9019,41
5/5/2021,South Korea,574,4,125519,1851,4168,26,8858,43
5/6/2021,South Korea,525,9,126044,1860,4037,32,8586,49
5/7/2021,South Korea,701,5,126745,1865,4111,34,8502,53
5/8/2021,South Korea,564,9,127309,1874,4069,41,8422,61
5/9/2021,South Korea,463,1,127772,1875,4044,41,8385,58
5/10/2021,South Korea,511,4,128283,1879,4014,39,8385,59
5/11/2021,South Korea,635,5,128918,1884,3973,37,8245,63
5/12/2021,South Korea,715,7,129633,1891,4114,40,8282,66
5/13/2021,South Korea,747,2,130380,1893,4336,33,8373,65
5/14/2021,South Korea,681,3,131061,1896,4316,31,8427,65
5/15/2021,South Korea,610,4,131671,1900,4362,26,8431,67
5/16/2021,South Korea,619,3,132290,1903,4518,28,8562,69
5/17/2021,South Korea,528,1,132818,1904,4535,25,8549,64
5/18/2021,South Korea,653,8,133471,1912,4553,28,8526,65
5/19/2021,South Korea,646,4,134117,1916,4484,25,8598,65
5/20/2021,South Korea,561,6,134678,1922,4298,29,8634,62
5/21/2021,South Korea,666,4,135344,1926,4283,30,8599,61
5/22/2021,South Korea,585,5,135929,1931,4258,31,8620,57
5/23/2021,South Korea,538,3,136467,1934,4177,31,8695,59
5/24/2021,South Korea,516,4,136983,1938,4165,34,8700,59
5/25/2021,South Korea,699,2,137682,1940,4211,28,8764,56
5/26/2021,South Korea,629,3,138311,1943,4194,27,8678,52
5/27/2021,South Korea,587,3,138898,1946,4220,24,8518,53
5/28/2021,South Korea,533,5,139431,1951,4087,25,8370,55
5/29/2021,South Korea,479,6,139910,1957,3981,26,8239,57
5/30/2021,South Korea,430,2,140340,1959,3873,25,8050,56
5/31/2021,South Korea,459,4,140799,1963,3816,25,7981,59
6/1/2021,South Korea,677,2,141476,1965,3794,25,8005,53
1/1/2021,United States,153628,2150,20252991,354330,1379788,18316,2678041,35765
1/2/2021,United States,300310,2508,20553301,356838,1453810,18938,2786445,35617
1/3/2021,United States,208746,1447,20762047,358285,1506921,18956,2807372,35349
1/4/2021,United States,184282,2094,20946329,360379,1516569,19046,2792605,35522
1/5/2021,United States,235111,3715,21181440,364094,1551428,19128,2829705,35838
1/6/2021,United States,255444,3927,21436884,368021,1573188,19322,2855531,36344
1/7/2021,United States,278290,3988,21715174,372009,1615811,19829,2939617,37423
1/8/2021,United States,295215,4108,22010389,376117,1757398,21787,3137186,40103
1/9/2021,United States,260695,3322,22271084,379439,1717783,22601,3171593,41539
1/10/2021,United States,213248,2000,22484332,381439,1722285,23154,3229206,42110
1/11/2021,United States,214994,2104,22699326,383543,1752997,23164,3269566,42210
1/12/2021,United States,226920,4475,22926246,388018,1744806,23924,3296234,43052
1/13/2021,United States,230362,4031,23156608,392049,1719724,24028,3292912,43350
1/14/2021,United States,235707,3988,23392315,396037,1677141,24028,3292952,43857
1/15/2021,United States,242731,3893,23635046,399930,1624657,23813,3382055,45600
1/16/2021,United States,201680,3404,23836726,403334,1565642,23895,3283425,46496
1/17/2021,United States,177782,1900,24014508,405234,1530176,23795,3252461,46949
1/18/2021,United States,143416,1535,24157924,406769,1458598,23226,3211595,46390
1/19/2021,United States,176706,2733,24334630,409502,1408384,21484,3153190,45408
1/20/2021,United States,183236,4408,24517866,413910,1361258,21861,3080982,45889
1/21/2021,United States,193818,4205,24711684,418115,1319369,22078,2996510,46106
1/22/2021,United States,190753,3847,24902437,421962,1267391,22032,2892048,45845
1/23/2021,United States,170613,3345,25073050,425307,1236324,21973,2801966,45868
1/24/2021,United States,131062,1899,25204112,427206,1189604,21972,2719780,45767
1/25/2021,United States,151969,1977,25356081,429183,1198157,22414,2656755,45640
1/26/2021,United States,147540,4008,25503621,433191,1168991,23689,2577375,45173
1/27/2021,United States,153945,3961,25657566,437152,1139700,23242,2500958,45103
1/28/2021,United States,168610,4039,25826176,441191,1114492,23076,2433861,45154
1/29/2021,United States,166568,3635,25992744,444826,1090307,22864,2357698,44896
1/30/2021,United States,142312,2786,26135056,447612,1062006,22305,2298330,44278
1/31/2021,United States,111997,1854,26247053,449466,1042941,22260,2232545,44232
2/1/2021,United States,135202,2067,26382255,451533,1026174,22350,2224331,44764
2/2/2021,United States,115333,3431,26497588,454964,993967,21773,2162958,45462
2/3/2021,United States,121641,3907,26619229,458871,961663,21719,2101363,44961
2/4/2021,United States,123975,3737,26743204,462608,917028,21417,2031520,44493
2/5/2021,United States,134397,3688,26877601,466296,884857,21470,1975164,44334
2/6/2021,United States,103987,2641,26981588,468937,846532,21325,1908538,43630
2/7/2021,United States,89648,1438,27071236,470375,824183,20909,1867124,43169
2/8/2021,United States,90315,1617,27161551,471992,779296,20459,1805470,42809
2/9/2021,United States,95632,3075,27257183,475067,759595,20103,1753562,41876
2/10/2021,United States,95177,3310,27352360,478377,733131,19506,1694794,41225
2/11/2021,United States,105760,3208,27458120,481585,714916,18977,1631944,40394
2/12/2021,United States,99638,2929,27557758,484514,680157,18218,1565014,39688
2/13/2021,United States,87122,2198,27644880,486712,663292,17775,1509824,39100
2/14/2021,United States,65021,1161,27709901,487873,638665,17498,1462848,38407
2/15/2021,United States,54186,959,27764087,488832,602536,16840,1381832,37299
2/16/2021,United States,62719,1750,27826806,490582,569623,15515,1329218,35618
2/17/2021,United States,70118,2406,27896924,492988,544564,14611,1277695,34117
2/18/2021,United States,69924,2519,27966848,495507,508728,13922,1223644,32899
2/19/2021,United States,79297,2631,28046145,498138,488387,13624,1168544,31842
2/20/2021,United States,71525,1818,28117670,499956,472790,13244,1136082,31019
2/21/2021,United States,57080,1249,28174750,501205,464849,13332,1103514,30830
2/22/2021,United States,56220,1323,28230970,502528,466883,13696,1069419,30536
2/23/2021,United States,72263,2274,28303233,504802,476427,14220,1046050,29735
2/24/2021,United States,74732,3179,28377965,507981,481041,14993,1025605,29604
2/25/2021,United States,77501,2446,28455466,510427,488618,14920,997346,28842
2/26/2021,United States,77346,2068,28532812,512495,486667,14357,975054,27981
2/27/2021,United States,64575,1515,28597387,514010,479717,14054,952507,27298
2/28/2021,United States,51357,1094,28648744,515104,473994,13899,938843,27231
3/1/2021,United States,58229,1522,28706973,516626,476003,14098,942886,27794
3/2/2021,United States,57060,1950,28764033,518576,460800,13774,937227,27994
3/3/2021,United States,67193,2491,28831226,521067,453261,13086,934302,28079
3/4/2021,United States,68051,1938,28899277,523005,443811,12578,932429,27498
3/5/2021,United States,66451,1785,28965728,524790,432916,12295,919583,26652
3/6/2021,United States,58203,1506,29023931,526296,426544,12286,906261,26340
3/7/2021,United States,41007,699,29064938,526995,416194,11891,890188,25790
3/8/2021,United States,45036,740,29109974,527735,403001,11109,879004,25207
3/9/2021,United States,57642,1807,29167616,529542,403583,10966,864383,24740
3/10/2021,United States,57920,1573,29225536,531115,394310,10048,847571,23134
3/11/2021,United States,62474,1569,29288010,532684,388733,9679,832544,22257
3/12/2021,United States,61523,1571,29349533,534255,383805,9465,816721,21760
3/13/2021,United States,52932,998,29402465,535253,378534,8957,805078,21243
3/14/2021,United States,38221,581,29440686,535834,375748,8839,791942,20730
3/15/2021,United States,56666,757,29497352,536591,387378,8856,790379,19965
3/16/2021,United States,53957,1179,29551309,537770,383693,8228,787276,19194
3/17/2021,United States,59136,1235,29610445,539005,384909,7890,779219,17938
3/18/2021,United States,60538,1666,29670983,540671,382973,7987,771706,17666
3/19/2021,United States,61629,1149,29732612,541820,383079,7565,766884,17030
3/20/2021,United States,55374,744,29787986,542564,385521,7311,764055,16268
3/21/2021,United States,33768,440,29821754,543004,381068,7170,756816,16009
3/22/2021,United States,51593,720,29873347,543724,375995,7133,763373,15989
3/23/2021,United States,53603,877,29926950,544601,375641,6831,759334,15059
3/24/2021,United States,86960,1513,30013910,546114,403465,7109,788374,14999
3/25/2021,United States,67465,1411,30081375,547525,410392,6854,793365,14841
3/26/2021,United States,77321,1155,30158696,548680,426084,6860,809163,14425
3/27/2021,United States,62700,788,30221396,549468,433410,6904,818931,14215
3/28/2021,United States,43097,523,30264493,549991,442739,6987,823807,14157
3/29/2021,United States,69429,713,30333922,550704,460575,6980,836570,14113
3/30/2021,United States,61249,887,30395171,551591,468221,6990,843862,13821
3/31/2021,United States,67039,1091,30462210,552682,448300,6568,851765,13677
4/1/2021,United States,79045,1078,30541255,553760,459880,6235,870272,13089
4/2/2021,United States,69831,953,30611086,554713,452390,6033,878474,12893
4/3/2021,United States,63067,737,30674153,555450,452757,5982,886167,12886
4/4/2021,United States,34972,294,30709125,555744,444632,5753,887371,12740
4/5/2021,United States,77679,519,30786804,556263,452882,5559,913457,12539
4/6/2021,United States,60544,861,30847348,557124,452177,5533,920398,12523
4/7/2021,United States,75038,2593,30922386,559717,460176,7035,908476,13603
4/8/2021,United States,79878,1023,31002264,560740,461009,6980,920889,13215
4/9/2021,United States,82698,890,31084962,561630,473876,6917,926266,12950
4/10/2021,United States,66535,718,31151497,562348,477344,6898,930101,12880
4/11/2021,United States,46380,301,31197877,562649,488752,6905,933384,12658
4/12/2021,United States,70230,477,31268107,563126,481303,6863,934185,12422
4/13/2021,United States,77878,833,31345985,563959,498637,6835,950814,12368
4/14/2021,United States,75375,975,31421360,564934,498974,5217,959150,12252
4/15/2021,United States,74289,900,31495649,565834,493385,5094,954394,12074
4/16/2021,United States,79991,872,31575640,566706,490678,5076,964554,11993
4/17/2021,United States,52373,695,31628013,567401,476516,5053,953860,11951
4/18/2021,United States,42018,336,31670031,567737,472154,5088,960906,11993
4/19/2021,United States,67933,501,31737964,568238,469857,5112,951160,11975
4/20/2021,United States,61273,842,31799237,569080,453252,5121,951889,11956
4/21/2021,United States,62857,861,31862094,569941,440734,5007,939708,10224
4/22/2021,United States,67257,963,31929351,570904,433702,5070,927087,10164
4/23/2021,United States,62399,780,31991750,571684,416110,4978,906788,10054
4/24/2021,United States,53363,745,32045113,572429,417100,5028,893616,10081
4/25/2021,United States,32065,291,32077178,572720,407147,4983,879301,10071
4/26/2021,United States,47691,493,32124869,573213,386905,4975,856762,10087
4/27/2021,United States,50856,654,32175725,573867,376488,4787,829740,9908
4/28/2021,United States,55125,970,32230850,574837,368756,4896,809490,9903
4/29/2021,United States,58199,869,32289049,575706,359698,4802,793400,9872
4/30/2021,United States,57922,746,32346971,576452,355221,4768,771331,9746
5/1/2021,United States,45303,721,32392274,577173,347161,4744,764261,9772
5/2/2021,United States,29367,342,32421641,577515,344463,4795,751610,9778
5/3/2021,United States,50560,494,32472201,578009,347332,4796,734237,9771
5/4/2021,United States,40733,886,32512934,578895,337209,5028,713697,9815
5/5/2021,United States,44735,790,32557669,579685,326819,4848,695575,9744
5/6/2021,United States,47514,802,32605183,580487,316134,4781,675832,9583
5/7/2021,United States,48160,759,32653343,581246,306372,4794,661593,9562
5/8/2021,United States,33622,622,32686965,581868,294691,4695,641852,9439
5/9/2021,United States,21392,243,32708357,582111,286716,4596,631179,9391
5/10/2021,United States,36898,410,32745255,582521,273054,4512,620386,9308
5/11/2021,United States,33651,680,32778906,583201,265972,4306,603181,9334
5/12/2021,United States,35878,858,32814784,584059,257115,4374,583934,9222
5/13/2021,United States,38087,811,32852871,584870,247688,4383,563822,9164
5/14/2021,United States,42298,660,32895169,585530,241826,4284,548198,9078
5/15/2021,United States,28813,481,32923982,586011,237017,4143,531708,8838
5/16/2021,United States,16864,271,32940846,586282,232489,4171,519205,8767
5/17/2021,United States,28666,395,32969512,586677,224257,4156,497311,8668
5/18/2021,United States,27819,764,32997331,587441,218425,4240,484397,8546
5/19/2021,United States,29293,658,33026624,588099,211840,4040,468955,8414
5/20/2021,United States,30141,668,33056765,588767,203894,3897,451582,8280
5/21/2021,United States,28341,605,33085106,589372,189937,3842,431763,8126
5/22/2021,United States,19778,481,33104884,589853,180902,3842,417919,7985
5/23/2021,United States,12853,191,33117737,590044,176891,3762,409380,7933
5/24/2021,United States,25925,428,33143662,590472,174150,3795,398407,7951
5/25/2021,United States,22756,621,33166418,591093,169087,3652,387512,7892
5/26/2021,United States,24052,965,33190470,592058,163846,3959,375686,7999
5/27/2021,United States,27525,1338,33217995,593396,161230,4629,365124,8526
5/28/2021,United States,21968,567,33239963,593963,154857,4591,344794,8433
5/29/2021,United States,11976,343,33251939,594306,147055,4453,327957,8295
5/30/2021,United States,6725,124,33258664,594430,140927,4386,317818,8148
5/31/2021,United States,5764,142,33264428,594572,120766,4100,294916,7895
6/1/2021,United States,23010,641,33287438,595213,121020,4120,290107,7772
1/1/2021,Vietnam,9,0,1474,35,35,0,64,0
1/2/2021,Vietnam,8,0,1482,35,42,0,71,0
1/3/2021,Vietnam,12,0,1494,35,53,0,81,0
1/4/2021,Vietnam,3,0,1497,35,46,0,83,0
1/5/2021,Vietnam,7,0,1504,35,50,0,84,0
1/6/2021,Vietnam,1,0,1505,35,49,0,84,0
1/7/2021,Vietnam,4,0,1509,35,44,0,77,0
1/8/2021,Vietnam,3,0,1512,35,38,0,73,0
1/9/2021,Vietnam,1,0,1513,35,31,0,73,0
1/10/2021,Vietnam,1,0,1514,35,20,0,73,0
1/11/2021,Vietnam,1,0,1515,35,18,0,64,0
1/12/2021,Vietnam,5,0,1520,35,16,0,66,0
1/13/2021,Vietnam,1,0,1521,35,16,0,65,0
1/14/2021,Vietnam,10,0,1531,35,22,0,66,0
1/15/2021,Vietnam,5,0,1536,35,24,0,62,0
1/16/2021,Vietnam,1,0,1537,35,24,0,55,0
1/17/2021,Vietnam,0,0,1537,35,23,0,43,0
1/18/2021,Vietnam,2,0,1539,35,24,0,42,0
1/19/2021,Vietnam,1,0,1540,35,20,0,36,0
1/20/2021,Vietnam,4,0,1544,35,23,0,39,0
1/21/2021,Vietnam,2,0,1546,35,15,0,37,0
1/22/2021,Vietnam,2,0,1548,35,12,0,36,0
1/23/2021,Vietnam,0,0,1548,35,11,0,35,0
1/24/2021,Vietnam,0,0,1548,35,11,0,34,0
1/25/2021,Vietnam,1,0,1549,35,10,0,34,0
1/26/2021,Vietnam,2,0,1551,35,11,0,31,0
1/27/2021,Vietnam,2,0,1553,35,9,0,32,0
1/28/2021,Vietnam,98,0,1651,35,105,0,120,0
1/29/2021,Vietnam,6,0,1657,35,109,0,121,0
1/30/2021,Vietnam,110,0,1767,35,219,0,230,0
1/31/2021,Vietnam,50,0,1817,35,269,0,280,0
2/1/2021,Vietnam,33,0,1850,35,301,0,311,0
2/2/2021,Vietnam,32,0,1882,35,331,0,342,0
2/3/2021,Vietnam,66,0,1948,35,395,0,404,0
2/4/2021,Vietnam,9,0,1957,35,306,0,411,0
2/5/2021,Vietnam,19,0,1976,35,319,0,428,0
2/6/2021,Vietnam,9,0,1985,35,218,0,437,0
2/7/2021,Vietnam,16,0,2001,35,184,0,453,0
2/8/2021,Vietnam,49,0,2050,35,200,0,501,0
2/9/2021,Vietnam,14,0,2064,35,182,0,513,0
2/10/2021,Vietnam,27,0,2091,35,143,0,538,0
2/11/2021,Vietnam,49,0,2140,35,183,0,489,0
2/12/2021,Vietnam,2,0,2142,35,166,0,485,0
2/13/2021,Vietnam,53,0,2195,35,210,0,428,0
2/14/2021,Vietnam,33,0,2228,35,227,0,411,0
2/15/2021,Vietnam,41,0,2269,35,219,0,419,0
2/16/2021,Vietnam,42,0,2311,35,247,0,429,0
2/17/2021,Vietnam,18,0,2329,35,238,0,381,0
2/18/2021,Vietnam,18,0,2347,35,207,0,390,0
2/19/2021,Vietnam,15,0,2362,35,220,0,386,0
2/20/2021,Vietnam,6,0,2368,35,173,0,383,0
2/21/2021,Vietnam,15,0,2383,35,155,0,382,0
2/22/2021,Vietnam,9,0,2392,35,123,0,342,0
2/23/2021,Vietnam,11,0,2403,35,92,0,339,0
2/24/2021,Vietnam,9,0,2412,35,83,0,321,0
2/25/2021,Vietnam,9,0,2421,35,74,0,281,0
2/26/2021,Vietnam,5,0,2426,35,64,0,284,0
2/27/2021,Vietnam,6,0,2432,35,64,0,237,0
2/28/2021,Vietnam,16,0,2448,35,65,0,220,0
3/1/2021,Vietnam,0,0,2448,35,56,0,179,0
3/2/2021,Vietnam,27,0,2475,35,72,0,164,0
3/3/2021,Vietnam,7,0,2482,35,70,0,153,0
3/4/2021,Vietnam,6,0,2488,35,67,0,141,0
3/5/2021,Vietnam,6,0,2494,35,68,0,132,0
3/6/2021,Vietnam,7,0,2501,35,69,0,133,0
3/7/2021,Vietnam,11,0,2512,35,64,0,129,0
3/8/2021,Vietnam,12,0,2524,35,76,0,132,0
3/9/2021,Vietnam,2,0,2526,35,51,0,123,0
3/10/2021,Vietnam,3,0,2529,35,47,0,117,0
3/11/2021,Vietnam,4,0,2533,35,45,0,112,0
3/12/2021,Vietnam,17,0,2550,35,56,0,124,0
3/13/2021,Vietnam,3,0,2553,35,52,0,121,0
3/14/2021,Vietnam,1,0,2554,35,42,0,106,0
3/15/2021,Vietnam,3,0,2557,35,33,0,109,0
3/16/2021,Vietnam,3,0,2560,35,34,0,85,0
3/17/2021,Vietnam,7,0,2567,35,38,0,85,0
3/18/2021,Vietnam,3,0,2570,35,37,0,82,0
3/19/2021,Vietnam,1,0,2571,35,21,0,77,0
3/20/2021,Vietnam,1,0,2572,35,19,0,71,0
3/21/2021,Vietnam,0,0,2572,35,18,0,60,0
3/22/2021,Vietnam,3,0,2575,35,18,0,51,0
3/23/2021,Vietnam,0,0,2575,35,15,0,49,0
3/24/2021,Vietnam,1,0,2576,35,9,0,47,0
3/25/2021,Vietnam,3,0,2579,35,9,0,46,0
3/26/2021,Vietnam,7,0,2586,35,15,0,36,0
3/27/2021,Vietnam,0,0,2586,35,14,0,33,0
3/28/2021,Vietnam,5,0,2591,35,19,0,37,0
3/29/2021,Vietnam,3,0,2594,35,19,0,37,0
3/30/2021,Vietnam,0,0,2594,35,19,0,34,0
3/31/2021,Vietnam,9,0,2603,35,27,0,36,0
4/1/2021,Vietnam,14,0,2617,35,38,0,47,0
4/2/2021,Vietnam,3,0,2620,35,34,0,49,0
4/3/2021,Vietnam,6,0,2626,35,40,0,54,0
4/4/2021,Vietnam,5,0,2631,35,40,0,59,0
4/5/2021,Vietnam,6,0,2637,35,43,0,62,0
4/6/2021,Vietnam,11,0,2648,35,54,0,73,0
4/7/2021,Vietnam,11,0,2659,35,56,0,83,0
4/8/2021,Vietnam,9,0,2668,35,51,0,89,0
4/9/2021,Vietnam,15,0,2683,35,63,0,97,0
4/10/2021,Vietnam,9,0,2692,35,66,0,106,0
4/11/2021,Vietnam,1,0,2693,35,62,0,102,0
4/12/2021,Vietnam,12,0,2705,35,68,0,111,0
4/13/2021,Vietnam,9,0,2714,35,66,0,120,0
4/14/2021,Vietnam,19,0,2733,35,74,0,130,0
4/15/2021,Vietnam,25,0,2758,35,90,0,141,0
4/16/2021,Vietnam,14,0,2772,35,89,0,152,0
4/17/2021,Vietnam,9,0,2781,35,89,0,155,0
4/18/2021,Vietnam,4,0,2785,35,92,0,154,0
4/19/2021,Vietnam,6,0,2791,35,86,0,154,0
4/20/2021,Vietnam,9,0,2800,35,86,0,152,0
4/21/2021,Vietnam,12,0,2812,35,79,0,153,0
4/22/2021,Vietnam,12,0,2824,35,66,0,156,0
4/23/2021,Vietnam,6,0,2830,35,58,0,147,0
4/24/2021,Vietnam,3,0,2833,35,52,0,141,0
4/25/2021,Vietnam,10,0,2843,35,58,0,150,0
4/26/2021,Vietnam,9,0,2852,35,61,0,147,0
4/27/2021,Vietnam,5,0,2857,35,57,0,143,0
4/28/2021,Vietnam,8,0,2865,35,53,0,132,0
4/29/2021,Vietnam,45,0,2910,35,86,0,152,0
4/30/2021,Vietnam,18,0,2928,35,98,0,156,0
5/1/2021,Vietnam,14,0,2942,35,109,0,161,0
5/2/2021,Vietnam,20,0,2962,35,119,0,177,0
5/3/2021,Vietnam,23,0,2985,35,133,0,194,0
5/4/2021,Vietnam,10,0,2995,35,138,0,195,0
5/5/2021,Vietnam,35,0,3030,35,165,0,218,0
5/6/2021,Vietnam,60,0,3090,35,180,0,266,0
5/7/2021,Vietnam,47,0,3137,35,209,0,307,0
5/8/2021,Vietnam,108,0,3245,35,303,0,412,0
5/9/2021,Vietnam,167,0,3412,35,450,0,569,0
5/10/2021,Vietnam,77,0,3489,35,504,0,637,0
5/11/2021,Vietnam,82,0,3571,35,576,0,714,0
5/12/2021,Vietnam,87,0,3658,35,628,0,793,0
5/13/2021,Vietnam,82,0,3740,35,650,0,830,0
5/14/2021,Vietnam,76,0,3816,35,679,0,888,0
5/15/2021,Vietnam,296,1,4112,36,867,1,1170,1
5/16/2021,Vietnam,100,1,4212,37,800,2,1250,2
5/17/2021,Vietnam,147,0,4359,37,870,2,1374,2
5/18/2021,Vietnam,153,0,4512,37,941,2,1517,2
5/19/2021,Vietnam,208,0,4720,37,1062,2,1690,2
5/20/2021,Vietnam,89,2,4809,39,1069,4,1719,4
5/21/2021,Vietnam,132,2,4941,41,1125,6,1804,6
5/22/2021,Vietnam,178,1,5119,42,1007,6,1874,7
5/23/2021,Vietnam,156,1,5275,43,1063,6,1863,8
5/24/2021,Vietnam,129,1,5404,44,1045,7,1915,9
5/25/2021,Vietnam,527,0,5931,44,1419,7,2360,9
5/26/2021,Vietnam,155,1,6086,45,1366,8,2428,10
5/27/2021,Vietnam,270,1,6356,46,1547,7,2616,11
5/28/2021,Vietnam,40,1,6396,47,1455,6,2580,12
5/29/2021,Vietnam,512,0,6908,47,1789,5,2796,11
5/30/2021,Vietnam,199,0,7107,47,1832,4,2895,10
5/31/2021,Vietnam,325,0,7432,47,2028,3,3073,10
6/1/2021,Vietnam,193,1,7625,48,1694,4,3113,11
